.,.,.,.,.,.,.,.,.,.,.,.,.,.,.,.,.,.,.,.
.,.,.,.,.,.,.,.,.,.,.,.,.,.,.,.,.,.,.,.
.,.,.,.,.,.,.,.,.,r,b,g,o,y,.,.,.,.,.,.
.,b,.,.,.,.,.,.,.,.,.,.,.,.,.,.,.,.,.,.
.,r,y,o,G,B,R,.,.,.,.,.,.,.,.,.,.,.,.,.
.,.,.,.,.,.,.,.,.,.,.,.,.,.,.,.,.,.,.,.
.,.,.,.,.,.,.,.,.,O,Y,R,.,.,.,.,.,.,.,.
.,.,.,.,.,.,.,.,.,.,.,.,.,.,.,.,.,.,.,.
.,.,.,.,R,B,G,.,.,.,g,.,.,.,B,G,O,.,.,.
.,+,.,.,.,.,.,.,.,.,b,.,.,.,.,.,.,.,.,.
r,r,b,b,g,g,o,o,y,y,r,b,g,o,y,r,b,g,o,y